16 16
7 7 7 7 7 7 1 7 7 7 7 7 1 1 7 7 
7 0 0 0 0 0 0 0 0 2 2 0 0 0 4 7 
7 0 0 0 0 0 0 0 0 11 2 0 0 0 0 7 
1 0 0 0 0 0 0 0 0 2 2 0 0 0 0 7 
7 0 0 0 0 0 0 0 0 2 2 0 0 0 0 7 
7 0 0 0 0 0 0 0 0 2 2 2 2 2 2 7 
1 0 0 0 0 0 0 0 0 0 0 0 0 0 0 1 
7 0 0 0 0 0 0 0 0 0 0 0 0 0 0 7 
7 8 8 8 8 8 0 0 0 8 8 8 8 8 8 7 
7 0 0 0 0 0 0 0 0 0 0 0 0 0 0 7 
7 0 0 0 0 0 0 0 0 0 0 0 0 0 0 7 
7 0 5 5 5 5 0 0 0 1 1 1 1 1 1 1 
1 0 0 0 0 5 0 0 0 1 0 0 0 0 0 7 
7 0 0 0 0 5 0 0 0 12 0 0 0 0 0 7 
7 0 0 0 0 5 0 0 0 1 0 0 0 0 0 7 
7 1 7 7 1 7 6 9 6 7 7 7 1 7 7 7 
