18 18
2 2 2 2 2 2 2 2 4 9 4 2 2 2 2 2 2 2 
2 0 0 0 0 0 0 0 0 0 0 0 0 0 0 0 0 2 
2 0 0 0 0 0 0 0 0 0 0 0 0 0 0 0 0 2 
2 0 0 0 0 0 0 0 0 0 0 0 0 0 0 0 0 2 
2 0 0 0 0 0 0 0 0 0 0 0 0 0 0 0 0 2 
2 0 0 0 0 5 5 5 5 5 5 0 5 0 0 0 0 2 
2 0 0 0 0 5 0 0 0 0 0 0 5 0 0 0 0 2 
2 0 0 0 0 5 0 0 0 0 0 0 5 0 0 0 0 2 
2 0 0 0 0 5 0 0 0 0 0 0 5 0 0 0 0 2 
2 0 0 0 0 5 0 0 0 0 0 0 5 0 0 0 0 2 
2 0 0 0 0 0 0 0 0 0 0 0 5 0 0 0 0 2 
2 0 0 0 0 5 0 0 0 0 0 0 5 0 0 0 0 2 
2 0 0 0 0 5 5 5 5 5 5 5 5 0 0 0 0 2 
2 0 0 0 0 0 0 0 0 0 0 0 0 0 0 0 0 2 
2 0 0 0 0 0 0 0 0 0 0 0 0 0 0 0 0 2 
2 0 0 0 0 0 0 0 0 0 0 0 0 0 0 0 0 2 
2 0 0 0 0 0 0 0 0 0 0 0 0 0 0 0 0 2 
2 2 2 2 2 2 2 2 4 4 2 2 2 2 2 2 2 2 
