24 24
2 2 2 2 2 2 2 2 13 2 2 2 2 2 2 2 2 2 2 2 2 2 2 2 
2 1 1 0 0 6 0 0 0 0 0 5 5 0 0 0 0 0 0 0 5 1 1 2 
2 1 1 1 0 6 0 0 0 0 0 5 5 0 0 0 0 0 0 0 5 1 1 2 
2 0 1 1 1 9 0 0 0 0 0 0 0 0 0 0 0 0 0 0 5 1 0 2 
2 0 0 1 1 6 0 0 0 0 0 5 5 0 0 0 0 5 5 5 1 0 0 2 
2 0 0 0 1 1 6 6 6 6 6 5 5 0 0 0 0 5 1 1 0 0 0 2 
2 0 0 0 0 1 1 1 0 0 8 8 8 0 0 0 0 5 1 0 0 0 0 2 
2 0 0 0 0 0 1 1 1 0 8 0 0 8 5 5 5 1 0 0 0 0 0 2 
2 0 0 0 0 0 0 1 1 1 8 0 0 8 1 1 1 0 0 0 0 0 0 2 
2 0 0 0 0 0 0 0 1 1 8 0 0 8 1 0 0 0 0 0 0 0 0 2 
2 0 0 0 0 0 2 2 2 2 4 0 0 4 5 5 5 5 0 0 0 0 0 2 
2 0 0 0 0 0 14 0 0 0 0 0 0 0 0 0 0 5 0 0 0 0 0 2 
2 0 0 0 0 0 15 0 0 0 0 0 0 0 0 0 0 5 0 0 0 0 0 2 
2 0 0 0 0 0 2 2 2 2 4 0 0 4 5 5 5 5 0 0 0 0 0 2 
2 8 8 8 8 8 8 8 8 8 3 0 0 3 8 8 8 8 8 8 8 8 8 2 
2 0 8 0 0 0 0 2 2 2 3 0 0 3 2 2 2 0 0 0 0 8 0 2 
2 0 8 0 0 0 0 0 2 2 3 0 0 3 2 2 0 0 0 0 0 8 0 2 
2 0 8 0 0 0 0 0 0 2 3 3 3 3 2 0 0 0 0 0 0 8 0 2 
2 0 8 0 0 0 0 0 0 0 0 0 0 0 0 0 0 0 0 0 0 8 0 2 
2 0 8 0 0 0 0 0 0 0 0 0 0 0 0 0 0 0 0 0 0 8 0 2 
2 0 8 0 0 0 0 0 0 0 0 0 0 0 0 0 0 0 0 0 0 8 0 2 
2 0 8 8 8 8 8 8 8 8 0 0 0 0 8 8 8 8 8 8 8 8 0 2 
2 0 0 0 0 0 0 0 0 0 2 4 4 2 0 0 0 0 0 0 0 0 0 2 
2 2 2 2 2 2 2 2 2 2 2 2 2 2 2 2 2 2 2 2 2 2 2 2 
