16 16
1 1 1 1 1 1 1 1 1 1 1 1 1 1 1 1 
1 0 0 0 0 0 0 0 5 0 0 0 0 0 0 1 
1 0 0 0 0 0 0 0 5 0 0 0 0 0 0 1 
1 0 0 0 0 0 0 0 5 0 0 0 0 0 0 1 
1 0 0 0 0 0 0 0 5 0 0 0 0 0 0 1 
1 0 0 0 0 0 0 0 5 0 0 0 0 0 0 1 
1 0 0 0 0 0 0 0 5 0 0 0 0 0 0 1 
1 2 2 2 2 2 2 0 0 0 0 0 0 0 0 1 
1 0 0 0 0 0 0 0 0 4 4 4 4 4 4 1 
1 0 0 0 0 0 0 3 0 0 0 0 0 0 0 1 
1 0 0 0 0 0 0 3 0 0 0 0 0 0 0 1 
1 0 0 0 0 0 0 3 0 0 0 0 0 0 0 1 
1 0 0 0 0 0 0 3 0 0 0 0 0 0 0 1 
1 0 0 0 0 0 0 3 0 0 0 0 0 0 0 1 
1 0 0 0 0 0 0 3 0 0 0 0 0 0 0 1 
1 1 1 1 1 1 1 1 1 1 1 1 1 1 1 1 
