16 16
1 1 1 1 1 1 1 1 1 1 1 1 1 1 1 1 
1 0 0 0 0 2 0 0 0 0 0 0 6 0 0 1 
1 0 0 0 0 0 0 0 0 0 0 0 6 0 0 1 
1 0 0 0 0 2 0 0 0 0 0 0 6 0 0 1 
1 0 0 0 0 2 0 0 0 0 0 0 6 6 0 1 
1 2 2 2 2 2 0 0 0 0 0 0 0 0 0 1 
1 0 0 0 0 0 0 0 0 0 0 0 0 0 0 1 
9 0 0 0 0 0 0 3 3 0 0 0 0 0 0 1 
1 0 0 0 0 0 0 3 3 0 0 0 0 0 0 1 
1 0 0 0 0 0 0 0 0 0 0 0 0 0 0 1 
1 0 0 0 0 0 0 0 0 0 0 0 0 0 0 1 
1 0 8 8 8 8 8 0 0 0 0 7 7 7 7 1 
1 0 0 0 0 0 8 0 0 0 0 7 0 0 0 1 
1 0 0 0 0 0 8 0 0 0 0 7 0 0 0 1 
1 0 0 0 0 0 0 0 0 0 0 0 0 0 0 1 
1 1 1 1 1 1 1 1 1 1 1 1 1 1 1 1 
