16 16
2 2 2 2 2 2 2 2 2 2 2 2 2 2 2 2 
6 0 0 0 7 0 0 0 0 0 7 0 7 0 7 2 
2 7 7 0 7 7 7 0 7 7 7 0 7 0 7 2 
2 0 0 0 0 0 0 0 0 0 7 0 0 0 0 2 
2 7 7 0 7 0 7 7 7 0 7 0 7 7 7 2 
2 0 0 0 7 0 0 0 0 0 0 0 7 0 0 2 
2 7 7 0 7 7 7 0 7 0 7 0 0 0 7 2 
2 0 0 0 0 0 0 0 7 0 0 0 7 0 0 2 
2 7 7 0 7 0 7 7 7 0 7 0 7 0 7 2 
2 0 0 0 7 0 0 0 0 0 7 0 0 0 7 2 
2 0 7 7 7 0 7 0 7 7 7 7 7 0 7 2 
2 0 0 0 0 0 7 0 0 0 0 0 7 0 0 2 
2 0 7 7 7 0 7 0 7 7 7 7 7 7 0 2 
2 0 7 0 0 0 7 0 7 0 7 0 0 0 0 2 
2 0 7 0 7 0 0 0 0 0 7 0 7 7 0 2 
2 2 2 2 2 2 2 2 2 2 2 9 2 2 2 2 
