16 16
6 6 6 6 6 6 6 6 6 6 6 6 6 6 6 6 
6 0 0 0 0 0 0 0 0 0 0 0 0 0 0 6 
6 0 0 0 0 0 0 0 0 0 0 0 0 0 0 6 
6 0 0 0 3 3 0 0 0 0 0 0 0 0 0 6 
6 0 3 3 2 4 3 0 0 0 0 0 0 0 0 6 
6 0 0 0 2 5 0 0 0 0 0 5 0 0 0 6 
6 0 0 0 2 5 5 5 0 0 0 5 0 0 0 6 
6 0 0 0 0 0 0 0 0 0 0 5 0 0 0 6 
6 0 0 0 0 0 0 5 0 0 0 5 0 0 0 6 
6 0 0 5 0 0 0 0 0 0 0 5 0 0 0 6 
6 0 0 0 5 5 5 0 0 0 0 5 0 0 0 6 
6 0 0 0 0 5 5 5 5 0 5 0 0 0 0 6 
6 0 0 0 0 5 0 0 5 5 5 0 0 0 0 6 
6 0 0 0 0 0 0 0 0 0 0 0 0 0 0 6 
6 0 0 0 0 0 0 0 0 0 0 0 0 0 0 6 
6 6 6 6 6 6 6 6 6 6 6 6 6 6 6 6 
